中国人民银行	中国人民银行
natia	nativ
nation	nation
iph	iphone
k	kA
中国	中国
genreic	genseric
history	history
中共革命	闹革命
王到	拣到
hexx	hexa
hello	hello
heoo	hcoo
xxxx	xxx
排	排
ixxx	iphonexx
网达	亨达
national	national
chat	chat
王道	王道
histor	istor
abdcd	abdc
sver	sver
